26 9
107 1 1 2 1 3 1 4 1 5 1 6 1 7 1 8 1 9 1 10 1 11 1 12 1
13 1 14 1 15 1 16 1 17 1 18 1 19 1 20 1 21 1 22 1 22 1
23 1 24 1 25 1 26 1 1 2 1 3 1 4 1 5 1 6 1 7 1 8 1 9
26 2 26 3 26 4 26 5 26 7 26 8 2 9 3 9 4 9 5 9 6 9 7 9
8 9 9 9 10 9 11 9 12 9 13 9 14 9 15 9 16 9 17 9 18 9
19 9 20 9 21 9 22 9 23 9 24 9 25 9 26 9 2 7 2 8 2 9 4 2
4 3 4 4 5 2 6 2 7 2 7 3 7 4 7 5 12 2 12 3 12 4 12 5
12 6 13 3 14 3 15 3 16 3 17 3 18 3 22 4 23 4 24 4 25 4
16 6 16 8 17 6 17 8 18 6 18 7 18 8 19 6 20 6 21 6 22 6
7 3 6 8 5 10 5 14 5 20 2 25 6 24 6
8 3 2 3 8 8 3 13 2 19 8 19  7 25 3 17 7
2 2
